Text-Based Adventure
An Interactive Fiction by Siddharth Maratha
Release 1 / Serial number 211011 / Inform 7 build 6M62 (I6/v6.33 lib 6/12N) SD

Julianna's Bedroom
The white walls of the room are matched by the color of the furniture. A rack of shoes sits neatly in one corner and the dresser and bedside table are clear of dust.

There is a book lying in the center of the bed.

>where is the book
That's not a verb I recognise.

>the living room is a room
That's not a verb I recognise.

>yes
That was a rhetorical question.

>ni
That's not a verb I recognise.

>no
That was a rhetorical question.